0001000001
0001001001
0001001001
0001001001
0011101001
0001001001
0000001001
0000001001
0011101001
0011111100